5 10
|--------|
|.#.|..-*|
|..-|.@..|
|.#....-.|
|--------|